{
	"grid" : [
		[0, 0, 0, 0, 2, 2, 0, 0, 0, 0],
		[0, 0, 0, 0, 2, 2, 0, 0, 0, 0],
		[0, 0, 0, 2, 2, 0, 0, 0, 0, 0],
		[0, 0, 0, 0, 0, 0, 0, 0, 0, 0],
		[0, 0, 0, 0, 1, 0, 0, 0, 0, 0],
		[0, 0, 0, 1, 1, 1, 0, 0, 0, 0],
		[0, 0, 1, 1, 1, 1, 0, 0, 0, 0]
	],

	"playerBase": {
		"asset": "stonebase",
		"row": 3,
		"col": 0
	},

	"enemyBase": {
		"asset": "tanbase",
		"row": 3,
		"col": 9
	}
}